70 70
2 5 16 16 16 16 16 16 16 16 16 16 16 16 16 16 16 16 16 16 16 16 16 16 16 16 16 16 10 10 16 16 16 16 16 16 16 16 16 11 7 16 16 16 16 16 16 16 16 16 16 16 16 16 16 16 16 16 16 16 16 16 16 16 16 16 16 0 0 16
26 33 5 16 16 16 16 16 16 16 16 16 16 16 16 16 16 2 24 24 5 16 16 16 16 16 16 16 0 8 16 16 16 16 16 16 16 16 16 0 0 16 16 16 16 16 16 16 16 16 16 16 16 16 16 16 16 16 16 16 16 16 16 16 16 16 16 0 0 16
26 0 0 24 5 16 16 16 16 16 16 16 16 16 16 16 16 28 27 27 29 16 16 16 16 16 16 16 0 0 16 16 16 16 16 16 16 16 16 0 0 16 16 16 16 16 16 16 11 16 16 16 16 16 16 16 16 16 16 16 16 16 16 16 16 16 16 0 0 16
26 0 0 0 33 24 24 24 13 0 7 16 16 16 16 16 16 16 0 0 16 16 16 16 16 16 16 16 0 0 16 16 16 16 16 16 16 16 16 0 0 16 16 16 16 16 16 16 16 16 16 16 16 16 16 16 16 16 16 16 16 16 16 16 16 16 16 0 0 16
26 0 0 8 14 27 27 27 13 0 0 16 16 16 16 16 16 16 0 7 16 16 16 16 16 16 16 16 0 0 16 16 16 16 16 16 16 16 16 0 0 16 16 16 16 16 16 16 16 16 16 16 16 16 16 16 16 16 16 16 16 16 16 16 16 16 16 0 0 16
28 27 27 27 29 16 16 16 16 0 0 16 16 16 16 10 16 16 0 8 16 16 16 16 16 16 16 16 8 0 16 16 16 16 16 16 16 16 16 0 0 0 0 0 8 0 0 0 0 0 0 0 0 0 0 0 16 16 16 16 16 16 16 16 16 16 16 0 0 16
16 16 16 16 16 16 16 16 16 0 0 16 16 16 16 16 16 16 0 0 16 16 16 16 16 16 16 16 0 0 16 16 16 16 16 16 16 16 16 0 0 8 0 0 0 0 0 0 0 0 0 0 0 0 0 0 16 16 10 10 16 16 16 16 16 16 16 0 0 16
16 16 16 16 16 16 16 16 16 0 0 16 16 16 16 16 16 16 0 0 16 16 16 16 16 16 16 16 0 0 16 16 16 16 16 16 16 16 16 16 16 16 16 16 16 0 0 16 16 16 16 16 16 16 0 0 16 16 16 16 16 16 16 16 16 16 16 0 0 16
2 5 16 16 16 16 16 16 16 7 0 16 16 16 16 16 16 16 0 0 16 16 16 10 10 16 16 16 0 8 16 16 16 16 16 16 16 16 16 16 16 16 16 16 16 0 0 16 16 16 16 16 16 16 0 0 0 13 0 0 0 13 0 0 16 16 16 0 0 16
26 25 16 16 16 16 16 16 16 0 0 16 16 16 16 16 16 16 0 0 16 16 16 16 16 16 16 16 0 0 16 16 16 16 16 16 2 24 24 24 6 16 16 16 16 0 0 16 16 16 16 16 16 16 0 0 0 0 0 0 0 0 0 0 0 0 13 0 0 13
26 0 0 16 16 16 16 16 16 0 0 16 16 16 16 16 16 16 0 0 0 0 0 0 0 0 0 0 0 0 16 16 16 16 16 16 26 0 0 0 25 16 16 16 16 0 0 16 16 16 16 16 16 16 0 0 0 13 0 0 0 13 0 0 16 0 0 0 0 0
26 0 0 35 35 35 35 35 35 0 0 16 16 16 16 16 16 16 0 0 0 0 0 0 8 0 0 0 0 0 16 16 16 16 0 0 26 0 0 0 25 16 16 16 16 0 0 16 16 16 16 13 13 16 16 16 16 16 16 16 16 16 16 16 16 0 0 0 0 0
26 0 0 16 16 16 16 16 16 0 0 16 16 16 16 16 16 16 0 0 16 16 16 16 16 16 16 16 16 16 16 16 16 16 0 16 26 0 0 0 25 16 16 16 16 0 0 16 16 16 16 16 16 16 16 16 16 16 16 16 16 16 16 16 16 16 13 0 0 13
26 25 16 16 16 16 16 16 16 0 0 16 16 16 16 16 16 16 0 0 16 16 16 16 16 16 16 16 16 16 16 16 16 16 0 16 28 27 27 27 29 16 16 16 16 0 0 16 16 16 16 16 16 16 16 16 16 16 16 16 16 16 16 16 16 16 16 0 0 16
28 29 16 16 16 16 16 16 16 0 0 24 24 24 24 24 24 13 13 0 16 16 16 16 16 16 16 16 16 16 16 16 16 16 0 16 16 16 16 16 16 16 16 16 16 0 0 16 16 16 16 16 16 16 16 16 16 16 16 16 16 16 16 16 16 16 16 0 0 16
16 16 16 16 16 16 16 16 16 0 0 27 27 27 27 27 27 13 13 0 16 16 16 16 16 16 16 16 16 16 16 16 16 16 0 16 16 16 16 16 16 16 16 16 16 0 0 16 16 16 16 16 16 16 16 16 16 16 16 16 16 16 16 16 16 16 16 0 0 16
16 16 16 16 16 16 16 16 16 0 0 16 16 16 16 16 16 34 34 16 16 16 16 16 16 16 16 16 16 16 16 16 16 16 0 16 16 16 16 16 16 16 16 16 16 0 0 16 16 16 16 16 16 16 16 16 16 16 16 16 16 16 16 16 16 16 16 0 0 16
16 16 16 16 0 0 0 0 0 0 0 16 16 16 16 16 16 34 34 16 16 16 16 16 16 16 16 16 16 16 16 16 16 0 0 0 16 16 16 16 16 16 16 16 16 0 0 16 16 16 16 16 16 16 16 16 16 16 16 16 16 16 16 16 16 16 16 0 0 16
16 16 16 16 0 0 16 16 16 16 16 16 16 16 16 16 16 34 34 16 16 16 16 16 16 2 24 24 24 24 24 24 24 0 0 0 24 24 24 24 24 24 24 24 24 0 0 24 24 24 24 24 24 5 16 16 16 16 16 16 16 16 16 16 16 16 16 0 0 16
16 16 16 16 0 0 16 16 16 16 16 16 16 16 16 16 16 34 34 16 16 16 16 16 16 26 8 27 27 27 27 27 27 0 0 0 27 27 27 27 27 27 27 27 27 0 0 27 27 27 27 27 27 29 16 16 16 16 16 16 16 16 16 16 16 16 16 0 0 16
16 16 16 16 0 0 16 16 16 16 16 16 16 16 16 16 16 34 34 16 16 16 16 16 16 26 25 16 16 16 16 16 16 0 0 0 16 16 16 16 16 16 16 16 16 0 0 16 16 16 16 16 16 16 16 16 16 16 16 16 16 16 16 0 0 0 16 0 0 16
7 0 0 8 0 0 16 16 16 16 16 16 16 16 16 16 16 34 34 16 16 16 16 16 16 26 25 16 16 16 16 16 16 16 16 16 16 16 16 16 16 16 16 16 16 0 0 16 16 16 16 16 16 16 16 16 16 16 16 16 16 16 16 0 0 0 16 0 0 16
0 0 0 0 0 0 16 16 16 16 16 16 16 16 16 16 16 34 34 16 16 16 16 16 16 26 25 16 16 16 16 16 16 16 16 16 16 16 16 16 16 16 16 16 16 0 0 16 16 16 16 16 16 16 16 16 16 16 16 16 16 16 16 0 0 0 16 0 0 16
0 0 16 16 16 16 16 16 16 16 16 16 16 16 16 16 16 34 34 16 16 16 16 16 16 26 25 16 16 16 16 16 16 16 16 16 16 16 16 16 16 16 16 16 16 0 0 16 16 16 16 16 16 16 16 16 16 16 16 16 16 16 16 16 16 16 16 0 0 16
0 0 16 16 16 16 16 16 16 16 16 16 16 16 16 16 16 34 34 16 16 16 16 16 16 26 25 16 16 16 16 16 16 16 16 16 16 16 16 16 16 16 16 16 16 0 0 16 16 16 16 16 16 0 0 0 0 0 16 16 16 16 16 16 16 16 16 0 0 16
0 0 16 16 16 16 16 16 16 16 16 16 16 16 16 16 16 34 34 16 16 16 16 16 16 26 25 16 16 16 16 16 16 16 16 16 16 16 16 16 16 16 16 16 16 0 0 16 16 16 16 16 16 0 0 0 0 0 16 16 16 16 16 16 16 16 16 0 0 16
0 0 16 16 16 16 16 16 16 16 16 16 16 16 16 16 16 34 34 16 16 16 16 16 16 26 25 16 16 16 16 16 16 16 16 16 16 16 16 16 16 16 16 16 0 0 0 0 16 10 16 10 16 0 0 0 0 0 16 16 16 16 16 16 16 16 16 0 0 16
0 0 16 16 16 16 16 16 16 16 16 16 16 16 16 16 16 34 34 16 16 16 16 16 16 26 25 16 16 16 16 16 16 16 16 16 16 16 16 16 16 16 16 16 0 0 0 0 35 35 35 35 35 0 0 0 0 0 16 16 16 16 16 0 0 0 16 0 0 16
0 0 16 16 16 16 16 16 16 16 0 0 0 0 0 0 0 34 39 35 35 35 35 35 35 0 0 0 16 16 16 16 16 16 16 16 16 16 16 16 16 16 16 16 0 0 0 0 16 10 16 10 16 0 0 0 0 0 16 16 16 16 16 0 0 0 16 0 0 16
0 0 16 16 16 16 16 16 16 16 0 0 0 0 0 0 0 39 35 35 35 35 35 35 35 0 10 0 16 16 16 16 16 16 16 16 16 16 16 16 16 16 16 16 16 16 16 16 16 16 16 16 16 16 16 16 16 16 16 16 16 16 16 0 0 0 16 0 0 16
16 16 16 16 16 16 16 16 16 16 0 0 16 16 16 16 16 16 16 16 16 16 16 16 16 0 0 0 16 16 16 16 16 16 16 16 16 16 16 16 16 16 16 16 16 16 16 16 16 16 16 16 16 16 16 16 16 16 16 16 16 16 16 16 16 16 16 0 0 16
16 16 16 16 16 16 16 16 16 16 0 0 16 16 16 16 16 16 16 16 16 16 16 16 16 16 16 16 16 16 16 16 16 16 16 16 16 16 16 16 16 16 16 16 16 16 16 16 16 16 16 16 16 16 16 16 16 16 16 16 16 16 16 16 16 16 16 0 0 16
16 16 16 16 16 16 16 16 16 16 0 0 16 16 16 16 16 16 16 16 16 16 16 16 16 16 16 16 16 16 16 16 16 16 16 16 16 16 16 16 16 16 16 16 16 16 16 16 16 16 16 16 16 16 16 16 16 16 16 16 16 16 16 16 16 16 16 0 0 16
16 16 2 24 5 16 16 16 16 0 0 0 0 16 16 16 16 16 16 16 16 16 16 16 16 16 16 16 16 16 16 16 16 16 16 16 16 16 16 16 16 16 16 16 16 16 16 16 16 16 16 16 16 16 16 16 16 16 16 16 16 16 16 16 16 16 16 0 0 16
16 16 26 31 25 16 16 16 16 0 0 0 0 16 16 16 16 16 16 16 16 16 16 16 16 16 16 16 16 16 16 16 16 16 16 16 16 16 16 16 16 16 16 16 16 16 16 16 16 16 16 16 16 16 16 16 16 16 16 16 16 16 16 16 16 16 16 0 0 16
16 16 28 27 29 16 16 16 16 0 0 0 0 16 16 16 16 16 16 16 16 16 16 16 16 16 16 16 16 16 16 16 16 16 16 16 16 16 16 16 16 16 16 16 16 16 16 16 16 16 16 16 16 16 16 16 16 16 16 16 16 16 16 0 0 0 16 0 0 16
16 16 16 16 16 16 16 16 16 16 16 16 16 16 16 16 16 16 16 16 16 16 16 16 16 16 16 16 16 16 16 16 16 16 16 16 16 16 16 16 16 16 16 16 16 16 16 16 16 16 16 16 16 16 16 16 16 16 16 16 16 16 16 0 0 0 16 0 0 16
16 16 16 16 16 16 16 16 16 16 16 16 16 16 16 16 16 16 16 16 16 16 16 16 16 16 16 16 16 16 16 16 16 16 16 16 16 16 16 16 16 16 16 16 16 16 16 16 16 16 16 16 16 16 16 16 16 16 16 16 16 16 16 0 0 0 16 0 0 16
16 16 16 16 16 16 16 16 16 16 16 16 16 16 16 16 16 16 16 16 16 16 16 16 16 16 16 16 16 16 16 16 16 16 16 16 16 16 16 16 16 16 16 16 16 16 16 16 16 16 16 16 16 16 16 16 16 16 16 16 16 16 16 16 16 16 16 0 0 16
16 16 16 16 16 16 16 16 16 16 16 16 16 16 16 16 16 16 16 16 16 16 16 16 16 16 16 16 16 16 16 16 16 16 16 16 16 16 16 16 16 16 16 16 16 16 16 16 16 16 16 16 16 16 16 16 16 16 16 16 16 16 16 16 16 16 16 0 0 16
16 16 16 16 16 16 16 16 16 16 16 16 16 16 16 16 16 16 16 16 16 16 16 16 16 16 16 16 16 16 16 16 16 16 16 16 16 16 16 16 16 16 16 16 16 16 16 16 16 16 16 16 16 16 16 16 16 16 16 16 16 16 16 16 16 16 16 0 0 16
16 16 16 16 16 16 16 16 16 16 16 16 16 16 16 16 16 16 16 16 16 16 16 16 16 16 16 16 16 16 16 16 16 16 16 16 16 16 16 16 16 16 16 16 16 16 16 16 16 16 16 16 16 16 16 16 16 16 16 16 16 16 16 16 16 16 16 0 0 16
16 16 16 16 16 16 16 16 16 16 16 16 16 16 16 16 16 16 16 16 16 16 16 16 16 16 16 16 16 16 16 16 16 16 16 16 16 16 16 16 16 16 16 16 16 16 16 16 16 16 16 16 16 16 16 16 16 16 16 16 16 16 16 16 16 16 16 0 0 16
16 16 16 16 16 16 16 16 16 16 16 16 16 16 16 16 16 16 16 16 16 16 16 16 16 16 16 16 16 16 16 16 16 16 16 16 16 16 16 16 16 16 16 16 16 16 16 16 16 16 16 16 16 16 16 16 16 16 16 16 16 16 16 16 16 16 16 0 0 16
16 16 16 16 16 16 16 16 16 16 16 16 16 16 16 16 16 16 16 16 16 16 16 16 16 16 16 16 16 16 16 16 16 16 16 16 16 16 16 16 16 16 16 16 16 16 16 16 16 16 16 16 16 16 16 16 16 16 16 21 1 21 16 16 16 16 16 0 0 16
16 16 16 16 16 16 16 16 16 16 16 16 16 16 16 16 16 16 16 16 16 16 16 16 16 16 16 16 16 16 16 16 16 16 16 16 16 16 16 16 16 16 16 16 16 16 16 16 16 16 16 16 16 16 16 16 16 16 16 0 0 0 0 0 0 0 0 0 0 16
16 16 16 16 16 16 16 16 16 16 16 16 16 16 16 16 16 16 16 16 16 16 16 16 16 16 16 16 16 16 16 16 16 16 16 16 16 16 16 16 16 16 16 16 16 16 16 16 16 16 16 16 16 16 16 16 16 16 16 0 0 0 0 0 0 0 0 0 0 16
16 16 16 16 16 16 16 16 16 16 16 16 16 16 16 16 16 16 16 16 16 16 16 16 16 16 16 16 16 16 16 16 16 16 16 16 16 16 16 16 16 16 16 16 16 16 16 16 16 16 16 16 16 16 16 16 16 16 16 21 0 21 16 16 16 16 16 16 16 16
16 16 16 16 16 16 16 16 16 16 16 16 16 16 16 16 16 16 16 16 16 16 16 16 16 16 16 16 16 16 16 16 16 16 16 16 16 16 16 16 16 16 16 16 16 16 16 16 16 16 16 16 16 16 16 16 16 16 16 16 16 16 16 16 16 16 16 16 16 16
16 16 16 16 16 16 16 16 16 16 16 16 16 16 16 16 16 16 16 16 16 16 16 16 16 16 16 16 16 16 16 16 16 16 16 16 16 16 16 16 16 16 16 16 16 16 16 16 16 16 16 16 16 16 16 16 16 16 16 16 16 16 16 16 16 16 16 16 16 16
16 16 16 16 16 16 16 16 16 16 16 16 16 16 16 16 16 16 16 16 16 16 16 16 16 16 16 16 16 16 16 16 16 16 16 16 16 16 16 16 16 16 16 16 16 16 16 16 16 16 16 16 16 16 16 16 16 16 16 16 16 16 16 16 16 16 16 16 16 16
16 16 16 16 16 16 16 16 16 16 16 16 16 16 16 16 16 16 16 16 16 16 16 16 16 16 16 16 16 16 16 16 16 16 16 16 16 16 16 16 16 16 16 16 16 16 16 16 16 16 16 16 16 16 16 16 16 16 16 16 16 16 16 16 16 16 16 16 16 16
16 16 16 16 16 16 16 16 16 16 16 16 16 16 16 16 16 16 16 16 16 16 16 16 16 16 16 16 16 16 16 16 16 16 16 16 16 16 16 16 16 16 16 16 16 16 16 16 16 16 16 16 16 16 16 16 16 16 16 16 16 16 16 16 16 16 16 16 16 16
16 16 16 16 16 16 16 16 16 16 16 16 16 16 16 16 16 16 16 16 16 16 16 16 16 16 16 16 16 16 16 16 16 16 16 16 16 16 16 16 16 16 16 16 16 16 16 16 16 16 16 16 16 16 16 16 16 16 16 16 16 16 16 16 16 16 16 16 16 16
16 16 16 16 16 16 16 16 16 16 16 16 16 16 16 16 16 16 16 16 16 16 16 16 16 16 16 16 16 16 16 16 16 16 16 16 16 16 16 16 16 16 16 16 16 16 16 16 16 16 16 16 16 16 16 16 16 16 16 16 16 16 16 16 16 16 16 16 16 16
16 16 16 16 16 16 16 16 16 16 16 16 16 16 16 16 16 16 16 16 16 16 16 16 16 16 16 16 16 16 16 16 16 16 16 16 16 16 16 16 16 16 16 16 16 16 16 16 16 16 16 16 16 16 16 16 16 16 16 16 16 16 16 16 16 16 16 16 16 16
16 16 16 16 16 16 16 16 16 16 16 16 16 16 16 16 16 16 16 16 16 16 16 16 16 16 16 16 16 16 16 16 16 16 16 16 16 16 16 16 16 16 16 16 16 16 16 16 16 16 16 16 16 16 16 16 16 16 16 16 16 16 16 16 16 16 16 16 16 16
16 16 16 16 16 16 16 16 16 16 16 16 16 16 16 16 16 16 16 16 16 16 16 16 16 16 16 16 16 16 16 16 16 16 16 16 16 16 16 16 16 16 16 16 16 16 16 16 16 16 16 16 16 16 16 16 16 16 16 16 16 16 16 16 16 16 16 16 16 16
16 16 16 16 16 16 16 16 16 16 16 16 16 16 16 16 16 16 16 16 16 16 16 16 16 16 16 16 16 16 16 16 16 16 16 16 16 16 16 16 16 16 16 16 16 16 16 16 16 16 16 16 16 16 16 16 16 16 16 16 16 16 16 16 16 16 16 16 16 16
16 16 16 16 16 16 16 16 16 16 16 16 16 16 16 16 16 16 16 16 16 16 16 16 16 16 16 16 16 16 16 16 16 16 16 16 16 16 16 16 16 16 16 16 16 16 16 16 16 16 16 16 16 16 16 16 16 16 16 16 16 16 16 16 16 16 16 16 16 16
16 16 16 16 16 16 16 16 16 16 16 16 16 16 16 16 16 16 16 16 16 16 16 16 16 16 16 16 16 16 16 16 16 16 16 16 16 16 16 16 16 16 16 16 16 16 16 16 16 16 16 16 16 16 16 16 16 16 16 16 16 16 16 16 16 16 16 16 16 16
16 16 16 16 16 16 16 16 16 16 16 16 16 16 16 16 16 16 16 16 16 16 16 16 16 16 16 16 16 16 16 16 16 16 16 16 16 16 16 16 16 16 16 16 16 16 16 16 16 16 16 16 16 16 16 16 16 16 16 16 16 16 16 16 16 16 16 16 16 16
16 16 16 16 16 16 16 16 16 16 16 16 16 16 16 16 16 16 16 16 16 16 16 16 16 16 16 16 16 16 16 16 16 16 16 16 16 16 16 16 16 16 16 16 16 16 16 16 16 16 16 16 16 16 16 16 16 16 16 16 16 16 16 16 16 16 16 16 16 16
16 16 16 16 16 16 16 16 16 16 16 16 16 16 16 16 16 16 16 16 16 16 16 16 16 16 16 16 16 16 16 16 16 16 16 16 16 16 16 16 16 16 16 16 16 16 16 16 16 16 16 16 16 16 16 16 16 16 16 16 16 16 16 16 16 16 16 16 16 16
16 16 16 16 16 16 16 16 16 16 16 16 16 16 16 16 16 16 16 16 16 16 16 16 16 16 16 16 16 16 16 16 16 16 16 16 16 16 16 16 16 16 16 16 16 16 16 16 16 16 16 16 16 16 16 16 16 16 16 16 16 16 16 16 16 16 16 16 16 16
16 16 16 16 16 16 16 16 16 16 16 16 16 16 16 16 16 16 16 16 16 16 16 16 16 16 16 16 16 16 16 16 16 16 16 16 16 16 16 16 16 16 16 16 16 16 16 16 16 16 16 16 16 16 16 16 16 16 16 16 16 16 16 16 16 16 16 16 16 16
16 16 16 16 16 16 16 16 16 16 16 16 16 16 16 16 16 16 16 16 16 16 16 16 16 16 16 16 16 16 16 16 16 16 16 16 16 16 16 16 16 16 16 16 16 16 16 16 16 16 16 16 16 16 16 16 16 16 16 16 16 16 16 16 16 16 16 16 16 16
16 16 16 16 16 16 16 16 16 16 16 16 16 16 16 16 16 16 16 16 16 16 16 16 16 16 16 16 16 16 16 16 16 16 16 16 16 16 16 16 16 16 16 16 16 16 16 16 16 16 16 16 16 16 16 16 16 16 16 16 16 16 16 16 16 16 16 16 16 16
16 16 16 16 16 16 16 16 16 16 16 16 16 16 16 16 16 16 16 16 16 16 16 16 16 16 16 16 16 16 16 16 16 16 16 16 16 16 16 16 16 16 16 16 16 16 16 16 16 16 16 16 16 16 16 16 16 16 16 16 16 16 16 16 16 16 16 16 16 16
16 16 16 16 16 16 16 16 16 16 16 16 16 16 16 16 16 16 16 16 16 16 16 16 16 16 16 16 16 16 16 16 16 16 16 16 16 16 16 16 16 16 16 16 16 16 16 16 16 16 16 16 16 16 16 16 16 16 16 16 16 16 16 16 16 16 16 16 16 16