25 25
16 16 16 16 16 16 16 16 16 16 16 26 25 16 16 16 16 16 16 16 16 16 16 16 16
16 16 16 16 16 16 16 16 16 16 16 26 25 16 16 16 16 16 16 16 16 16 16 16 16
16 16 16 16 16 16 16 16 16 16 16 26 25 16 16 16 16 16 16 16 16 16 16 16 16
16 2 24 5 16 16 16 2 24 24 24 32 33 24 24 24 5 16 16 16 16 16 16 16 16
16 26 13 25 16 16 16 26 0 0 0 0 0 13 0 0 25 16 16 16 16 16 16 16 16
16 28 30 29 16 16 16 26 0 8 0 0 0 0 0 0 25 16 16 16 16 16 16 16 16
16 16 34 16 16 16 16 26 0 0 0 0 0 0 0 0 25 16 16 16 16 16 16 16 16
16 16 34 16 16 16 16 26 0 0 0 0 0 0 0 0 25 16 16 16 16 16 16 16 16
16 16 34 16 16 16 16 26 0 0 0 0 0 0 0 0 25 16 16 16 16 16 16 16 16
16 16 39 35 35 35 35 36 0 0 0 0 0 0 0 8 25 16 16 16 16 16 16 16 16
16 16 16 16 16 16 16 26 8 0 0 0 0 0 0 0 25 16 16 16 16 16 16 16 16
16 16 16 16 16 16 16 26 0 0 0 0 0 0 0 0 25 16 16 16 16 16 16 16 16
16 16 16 16 16 16 16 26 0 0 0 0 0 0 13 0 25 16 16 16 16 16 16 16 16
16 16 16 16 16 16 16 26 0 0 0 0 0 0 0 0 25 16 16 16 16 16 16 16 16
16 16 16 16 16 16 16 26 0 0 0 0 13 0 0 0 25 16 16 16 16 16 16 16 16
16 16 16 16 16 16 16 26 0 0 0 0 0 0 0 0 25 16 16 16 16 16 16 16 16
16 16 16 16 16 16 16 26 0 0 8 0 0 0 0 0 25 16 16 16 16 16 16 16 16
16 16 16 16 16 16 16 26 0 0 0 0 0 0 0 0 33 5 16 16 2 24 6 16 16
16 16 16 16 16 16 16 26 0 13 0 0 0 0 13 0 0 37 35 35 36 0 25 16 16
16 16 16 16 16 16 16 26 0 0 0 0 0 0 0 0 14 29 16 16 28 27 29 16 16
16 16 16 16 16 16 16 26 0 0 0 0 0 0 0 0 25 16 16 16 16 16 16 16 16
16 16 16 16 16 16 16 26 0 0 0 0 0 13 0 0 25 16 16 16 16 16 16 16 16
16 16 16 16 16 16 16 28 31 8 0 0 0 0 0 14 29 16 16 16 16 16 16 16 16
16 16 16 16 16 16 16 16 28 27 27 27 27 27 27 29 16 16 16 16 16 16 16 16 16
16 16 16 16 16 16 16 16 16 16 16 16 16 16 16 16 16 16 16 16 16 16 16 16 16