17 14
16 16 16 16 16 16 16 16 16 16 16 16 16 16 16 16 16
16 2 24 24 24 24 24 24 24 24 24 24 24 24 24 14 16
16 26 12 0 0 0 0 0 0 0 0 0 0 0 0 25 16
16 26 0 0 0 0 0 0 0 0 0 0 0 0 0 25 16
16 26 0 0 0 0 0 0 0 0 0 0 7 0 0 25 16
16 26 0 0 0 0 0 0 0 0 0 0 0 0 0 25 16
16 26 0 0 0 0 0 0 0 0 0 0 0 0 0 25 16
16 26 0 0 0 0 0 0 0 0 0 0 0 0 0 25 16
16 26 0 12 0 0 0 0 0 0 0 0 0 0 0 25 16
16 26 0 0 0 0 0 0 0 0 0 0 0 0 0 25 16
16 26 0 0 0 0 0 0 0 0 12 0 0 0 0 25 16
16 26 0 0 0 7 0 0 0 0 0 0 0 0 0 25 16
16 28 27 27 27 27 27 27 27 27 27 27 27 27 27 29 16
16 16 16 16 16 16 16 16 16 16 16 16 16 16 16 16 16