17 14
16 16 16 16 16 16 16 16 16 16 16 16 16 16 16 16 16
16 0 12 0 0 0 0 0 0 0 0 0 0 0 0 0 16
16 0 0 0 0 0 0 0 0 0 0 0 0 0 0 0 16
16 0 0 0 0 0 0 0 0 0 0 0 0 0 0 0 16
16 0 0 0 0 0 0 0 0 0 0 0 7 0 0 0 16
16 0 0 0 0 0 0 0 0 0 0 0 0 0 0 0 16
16 0 0 0 0 0 0 0 0 0 0 0 0 0 0 0 16
16 0 0 0 0 0 0 0 0 0 0 0 0 0 0 0 16
16 0 0 12 0 0 0 0 0 0 0 0 0 0 0 0 16
16 0 0 0 0 0 0 0 0 0 0 0 0 0 0 0 16
16 0 0 0 0 0 0 0 0 0 12 0 0 0 0 0 16
16 0 0 0 0 0 0 0 0 0 0 0 0 0 0 0 16
16 0 0 0 0 7 0 0 0 0 0 0 0 0 0 0 16
16 16 16 16 16 16 16 16 16 16 16 16 16 16 16 16 16