17 14
16 16 16 16 16 16 16 16 26 25 16 16 16 16 16 16 16
16 16 16 16 16 16 16 16 26 25 16 16 16 16 16 16 16
16 16 16 16 16 16 16 16 26 25 16 16 16 16 16 16 16
16 2 24 24 24 24 24 24 32 33 24 24 24 24 24 5 16
16 26 0 0 0 0 0 0 0 0 0 0 8 0 0 25 16
16 26 0 0 0 0 0 0 0 0 0 0 0 0 0 25 16
16 26 0 0 0 0 0 0 0 0 0 0 0 0 0 25 16
16 26 0 0 0 0 0 0 0 0 0 0 0 0 0 25 16
16 26 0 13 0 0 0 0 0 0 0 0 0 0 0 25 16
16 26 0 0 0 0 0 0 0 0 0 0 0 0 0 25 16
16 26 0 0 0 0 0 0 0 0 13 0 0 0 0 25 16
16 26 0 0 0 8 0 0 0 0 0 0 0 0 0 25 16
16 28 27 27 27 27 27 27 27 27 27 27 27 27 27 29 16
16 16 16 16 16 16 16 16 16 16 16 16 16 16 16 16 16