17 13
0 0 0 0 0 0 0 0 0 0 0 0 0 0 0 0 0
17 19 0 0 0 0 0 0 0 0 0 7 0 0 0 0 0
16 16 0 0 0 0 0 0 0 0 0 0 0 0 0 0 0
16 16 0 0 0 0 0 0 0 0 0 0 0 0 0 0 0
16 16 0 0 0 0 0 0 0 0 0 0 0 0 12 0 0
24 24 0 0 12 0 0 0 0 0 0 0 0 0 0 0 0
0 0 0 0 0 0 0 0 0 0 18 17 17 17 19 0 0
0 0 0 0 0 0 0 0 0 0 16 16 16 16 16 0 0
0 0 0 0 0 0 0 0 0 0 16 16 16 21 16 0 0
0 0 7 0 0 0 0 0 0 0 16 22 16 16 16 1 0
0 0 12 0 0 0 0 0 0 0 24 24 24 24 24 0 0
0 0 0 0 0 0 0 0 0 0 0 0 0 0 0 0 0
0 0 0 0 0 0 0 0 0 0 0 12 0 0 0 0 0