37 25
16 16 16 16 16 16 16 16 16 16 16 16 16 16 16 16 16 16 16 16 16 16 16 16 16 16 16 16 16 16 16 16 16 16 16 16 16
16 10 10 10 10 10 16 10 10 10 10 10 16 10 10 10 10 16 16 10 10 10 10 10 16 10 16 16 16 10 16 10 10 10 10 10 16
16 10 16 16 16 16 16 16 16 10 16 16 16 10 16 16 16 10 16 10 16 16 16 16 16 10 16 16 16 10 16 16 16 10 16 16 16
16 10 16 16 16 16 16 16 16 10 16 16 16 10 16 16 10 10 16 10 16 16 16 16 16 10 16 16 16 10 16 16 16 10 16 16 16
16 10 16 16 16 16 16 16 16 10 16 16 16 10 10 10 10 16 16 10 16 16 16 16 16 10 16 16 16 10 16 16 16 10 16 16 16
16 10 10 10 10 10 16 10 10 10 10 10 16 10 16 16 16 10 16 10 10 10 10 10 16 10 10 10 10 10 16 16 16 10 16 16 16
16 16 16 16 16 16 16 16 16 16 16 16 16 16 16 16 16 16 16 16 16 16 16 16 16 16 16 16 16 16 16 16 16 16 16 16 16
16 16 9 9 9 9 16 9 16 16 16 9 16 9 9 9 9 9 16 9 9 9 9 9 16 9 9 9 9 9 16 9 16 16 16 9 16
16 9 16 16 16 16 16 9 16 16 16 9 16 16 16 9 16 16 16 16 16 9 16 16 16 9 16 16 16 16 16 9 16 16 16 9 16
16 16 9 9 9 16 16 9 16 9 16 9 16 16 16 9 16 16 16 16 16 9 16 16 16 9 16 16 16 16 16 9 9 9 9 9 16
16 16 16 16 16 9 16 9 9 16 9 9 16 16 16 9 16 16 16 16 16 9 16 16 16 9 16 16 16 16 16 9 16 16 16 9 16
16 9 9 9 9 16 16 9 16 16 16 9 16 9 9 9 9 9 16 16 16 9 16 16 16 9 9 9 9 9 16 9 16 16 16 9 16
16 16 16 16 16 16 16 16 16 16 16 16 16 16 16 16 16 16 16 16 16 16 16 16 16 16 16 16 16 16 16 16 16 16 16 16 16
16 16 16 16 16 16 16 16 16 16 16 16 16 16 16 16 16 16 16 16 16 16 16 16 16 16 16 16 16 16 16 16 16 16 16 16 16
16 16 16 16 16 16 16 16 16 16 16 16 16 16 16 16 16 16 16 16 16 16 16 16 16 16 16 16 16 16 16 16 16 16 16 16 16
16 16 16 16 16 16 16 16 16 16 16 16 16 16 16 16 16 16 16 16 16 16 16 16 16 16 16 16 16 16 16 16 16 16 16 16 16
16 16 16 16 16 16 16 16 16 16 16 16 16 16 16 16 16 16 16 16 16 16 16 16 16 16 16 16 16 16 16 16 16 16 16 16 16
16 16 16 16 16 16 16 16 16 16 16 16 16 16 16 16 16 16 16 16 16 16 16 16 16 16 16 16 16 16 16 16 16 16 16 16 16
16 16 16 16 16 16 16 16 16 16 16 16 16 16 16 16 16 16 16 16 16 16 16 16 16 16 16 16 16 16 16 16 16 16 16 16 16
16 16 16 16 16 16 16 16 16 16 16 16 16 16 16 16 16 16 16 16 16 16 16 16 16 16 16 16 16 16 16 16 16 16 16 16 16
16 16 16 16 16 16 16 16 16 16 16 16 16 16 16 16 16 16 16 16 16 16 16 16 16 16 16 16 16 16 16 16 16 16 16 16 16
16 16 16 16 16 16 16 16 16 16 16 16 16 16 16 16 16 16 16 16 16 16 16 16 16 16 16 16 16 16 16 16 16 16 16 16 16
16 16 16 16 16 16 16 16 16 16 16 16 16 16 16 16 16 16 16 16 16 16 16 16 16 16 16 16 16 16 16 16 16 16 16 16 16
16 16 16 16 16 16 16 16 16 16 16 16 16 16 16 16 16 16 16 16 16 16 16 16 16 16 16 16 16 16 16 16 16 16 16 16 16
16 16 16 16 16 16 16 16 16 16 16 16 16 16 16 16 16 16 16 16 16 16 16 16 16 16 16 16 16 16 16 16 16 16 16 16 16